222111222
222111222
211111112
211101112
211111112
222111222
222111222
