222000222
222000222
200001002
200110002
200010002
222000222
222000222